abcZ	./abcZ.fasta
adk	./adk.fasta
aroE	./aroE.fasta
fumC	./fumC.fasta
gdh	./gdh.fasta
pdhC	./pdhC.fasta
pgm	./pgm.fasta
porA	./porA.fasta
porB	./porB.fasta
fetA	./fetA.fasta
nadA	./nadA.fasta
NadA_pep	./NadA_pep.fasta
nhbA	./nhbA.fasta
NhbA_pep	./NhbA_pep.fasta
fHbp	./fHbp.fasta
NEIS0349(fHbp)	./NEIS0349(fHbp).fasta
FHbp_pep	./FHbp_pep.fasta
PorA_VR1_pep	./PorA_VR1_pep.fasta
PorA_VR2_pep	./PorA_VR2_pep.fasta
FetA_VR_pep	./FetA_VR_pep.fasta
_porB	./_porB.fasta
sodC	./sodC.fasta
csaA	./csaA.fasta
csaB	./csaB.fasta
csaC	./csaC.fasta
csaD	./csaD.fasta
csxA	./csxA.fasta
csxB	./csxB.fasta
csxC	./csxC.fasta
csb	./csb.fasta
csc	./csc.fasta
csw	./csw.fasta
csy	./csy.fasta
ctrA	./ctrA.fasta
ctrB	./ctrB.fasta
ctrC	./ctrC.fasta
ctrD	./ctrD.fasta
cssA	./cssA.fasta
cssB	./cssB.fasta
cssC	./cssC.fasta
cssE	./cssE.fasta
ctrG	./ctrG.fasta
ctrE	./ctrE.fasta
ctrF	./ctrF.fasta
cnl	./cnl.fasta
_rplF	./_rplF.fasta
gyrA	./gyrA.fasta
penA	./penA.fasta
rpoB	./rpoB.fasta
ponA	./ponA.fasta
NEIS1320(gyrA)	./NEIS1320(gyrA).fasta
parC	./parC.fasta
parE	./parE.fasta
folP	./folP.fasta
mtrR	./mtrR.fasta
NEIS1753(penA)	./NEIS1753(penA).fasta
plasmid_blam	./plasmid_blam.fasta
plasmid_replicat	./plasmid_replicat.fasta
plasmid_tetM	./plasmid_tetM.fasta
oriT	./oriT.fasta
Hi_adk	./Hi_adk.fasta
atpG	./atpG.fasta
frdB	./frdB.fasta
fucK	./fucK.fasta
mdh	./mdh.fasta
pgi	./pgi.fasta
recA	./recA.fasta
ftsI	./ftsI.fasta
nadR_tentative	./nadR_tentative.fasta
lnt_tentative	./lnt_tentative.fasta
nspA_tentative	./nspA_tentative.fasta
